******************************************************************
*.....................*.......S........*.........................*
*.....................*................*.........................*
*.....................******************.........................*
*................................................................*
*......................................*.........................*
*................................................................*
*..............*......................................*..........*
*................................................................*
*................................*...............................*
*......................................YL........................*
*................................................................*
*................................................................*
*................................................................*
******************************************************************